# # # # # # # # # # # # # # # # # # # # # # # # # # # # # # # # # #
# . . . . . . . . . . # . # . . . # . . . . . . . . . . # # # . . #
# # # . # . # # # . . . # . . # . # # # . # . # # # . . . # . . # #
# . . # . . # . . # . . # . # . # . . . # . . # . . # . . # . # . #
# . . # . . # . . # . # # . # . . # . . # . . # . . # . # # . # . #
# . . # . . # . . . . . . . # . . # . . . . . # . # # . . . . # . #
# . . # . # # # # # # . . . # . . . . . . . . # . # . . . # # . . #
# . # . . . . . . . # . # # . . . # . . . . . . . # # # # . . . . #
# . # # # # # . # . # . . # . # . # # # # # . # # . . . . . # . . #
# . . . . . . . # . # . . # # . . . . . # . . # # # . . . . # . . #
# # # # . # . . # . . # # . # . . # . . # # . # . . # # . . . . . #
# . . . . # . # . # # . # # # # . # . . # . . # . . # # # # # . . #
# . # . . . . # . # . . . . . . . . . . # . . # . . . . . . . . . #
# . # # # # # # # . # # # # . . . # # . # . . # . . . . . . . # . #
# . . . . . . . . . . # . # # # # # # . . # . . . . . . # . # . . #
# # # . # . # # # . . . # . . # # # # # . # . # # # . . . # . . # #
# . . # . . # . . # . . # . # . # # . . # . . # . . # . . # . # . #
# . . # . . # . . # . # # # # . # # . # . . . # . . # # # # . # . #
# . . # . . # . . . . . . . # . . # . # # . . # . # # . . . . # . #
# . . # . # # # # # # . . . # . . . . . . # # # . . . . . . . # . #
# . # . . . . . . . # . # # . . . # . . . . # # # . # . . . # # . #
# . # # # # # . # . # . . # . # . # . . # . . . # . # # # # # . . #
# . . . . . . . # . # . . # # . . # . . # . . . # . # . . . # . . #
# # # # . # . . # . . # # . # . . . . . # . . . . . # . # . # . . #
# . . . . # . # . # # . # # . # . # . . # # . # . # . # # . # . . #
# . # . . . . # . # . . . . # . . # . . # . . # . . . # # . . . . #
# O . # . . # . . . . # . . # . . . . # . . . # . # . # . . # . . #
# # # # # # # # # # # # # # # # # # # # # # # # # # # # # # # # # #