# # # # # # # # # # # # # # # # #
# . . . . . . . . . . # . # . . #
# # # . # . # # # . . . # . . # #
# . . # . . # . . # . . # . # . #
# . . # . . # . . # . # # . # . #
# . . # . . # . . . . . . . # . #
# . . # . # # # # # # . . . # . #
# . # . . . . . . . # . # # . . #
# . # # # # # . # . # . . # . # #
# . . . . . . . # . # . . # # . #
# # # # . # . . # . . # # . # . #
# . . . . # . # . # # . # # . # #
# O # . . . . # . # . . . . . . #
# # # # # # # # # # # # # # # # #
