# # # # # # # # # 
# . # . . . # . #
# . . . # # # . # 
# . . . O . . . #
# # # # . # . . # 
# . . . . # . # # 
# . # # . # . # #
# # # # # # # # # 
