# # # # # # # #
# . . . . # . #
# # # . # # # #
# # # . # . . #
# . . . . # . #
# O # . # . . #
# # # # # # # #