# # # # # # # # # # # # # # # # #
# . . . # . . . . . . # . # . . #
# # # # # . # # # . . . # # . # #
# . . . . . . . . . . . . . . . #
# . . . . . . . . . # # # # # . #
# . . . . . . # # . . . . # . . #
# . . . . . . . # . # . . . . . #
# . . . . . # . # . # . # . . . #
# . . . # # # . # # # . # # . . #
# . . . . . . . . . . # . . . . #
# # # # . # . . # . . # . . . . #
# . . . . # . # . . . . . . . . #
# O # # . # . # . # . . . . . . #
# # # # # # # # # # # # # # # # #
