# # # # # # # # # # # # # # # # #
# . . . # . . . . . . # . # . . #
# # # # # . # # # . . . # # . # #
# . . # . . # . . # . . # . # . #
# . . # . . # . . # . # # . # . #
# . . # . . # . . . . . . . # . #
# . . # . . # # # # # . . . # . #
# . # . . . # . . . # # # # . . #
# . # # # # # . # . # . . # . # #
# . . . . . . . # . # # . # # . #
# # # # . # . . # # . # # . # . #
# . . . . # . # . # # . # # . # #
# O # # . # . # . # . . . . . . #
# # # # # # # # # # # # # # # # #
