# # # # # # # # # 
# . # . . . # . #
# . # . # # # . # 
# . # . . O . . #
# . . # . # . . # 
# . . . . # . # # 
# . # # . # . # #
# # # # # # # # # 
